_________                      .__                       __    
\_   ___ \  ____   ____   ____ |__|____________    _____/  |_  
/    \  \/ /  _ \ / ___\ /    \|  \___   /\__  \  /    \   __\ 
\     \___(  <_> ) /_/  >   |  \  |/    /  / __ \|   |  \  |   
 \______  /\____/\___  /|___|  /__/_____ \(____  /___|  /__|   
        \/      /_____/      \/         \/     \/     \/       
       
       

